_______7##########################################################################################e
________7#########################################################################################e
_________7########################################################################################e
__________7#######################################################################################e
__________________________________________________________________________________________________e
__________________________________________________________________________________________________e
__________________________________________________________________________________________________e
__________________________________________________________________________________________________e
__________J#######################################################################################e
_________J########################################################################################e
________J#########################################################################################e
_______J##########################################################################################e