_______#____JL________________________________e___________________
_______#____7r__JL____JL____JL____JL____JL____e___________________
_______#_______Jr7L___7r___Jr7L___7r___Jr7L___e___________________
_______#__JL__Jr__7L______Jr__7L______Jr__7L__e___________________
_______#_Jr7LJr____7######r____7L____Jr____7L_e___________________
_______#Jr__7r______________JL__7L__Jr__JL__7Le___________________
_______#r_______JL_________Jr7L__7LJr__Jr7L__7e___________________
_______r_______Jr7L_______Jr__7L__7r__Jr__7L__e___________________
__________JL__Jr__7#######r____7L____Jr____7L_e___________________
_________Jr7LJr_____________JL__7L__Jr__JL__7Le___________________
________Jr__7r__JL____JL____7r___7LJr___7r___7e___________________
_______Jr_______7r____7r__________7r__________e___________________